########
#P  #C##
##C #  #
#     Z#
###C  ##
########
