################
#...........####
####.#####.#K#X#
#zC#..#Z...#.#.#
#.##..####.#.#.#
#..#..#C...z.#.#
#..#Z.#####..#.#
#.##..#C.....#.#
#.....########.#
#####.#...D....#
#C....Z...####C#
################