################
#P..z.D..Z....C#
#.##.#######.###
#.##.##Cz###.###
#...C###.....Z##
#.#####C.###.###
#.#S########.###
#.#.###.......##
#.#.###.####Z.K#
#.#.#K#.########
#Z....#.C...D.X#
################