################
#...........####
####.#####.#.#X#
#zC#..#Z...#.#.#
#.##..####.#.#.#
#..#..#C...z.#.#
#..#Z.#####..#.#
#.##..#C.....#.#
#.....########.#
#####.#........#
#C....Z...####C#
################
