################
#  K#    #XD  P#
# ### ##  ##Z  #
# C #z  #  #  Z#
# ### # # ##C  #
#   # # #z  #  #
### # # ### # ##
# C #  z# C #S #
# ### ###z#### # 
# #   ###  C#  #
#   #####     ##
################