################
#P  #    C     #
# ### ### ###  #
# C #z  #   #  #
# ### # # ### ##
#   # # #   # ##
### # # ### # ##
# C #   # C #  #
# ### ### ### ## 
#       #  C#  #
# # ### # ### X#
################
