################
#C....##K#.D..C#
#.###.##.#.##z##
#...#.#...Z#####
###D#....###...#
###.#.####K..#.#
#K..#.##z####Z.#
###.#..........#
#C..####.##C##.# 
###.#X####z###.#
#P.z#.D.C......#
################