########
#Z  #X##
##C # C#
#     Z#
###P  ##
########
