########
#Z  #X##
##C # C#
#     Z#
##SP  ##
########
